Year,Month,Min,Avg,Max,Max to graph
2014,Sep,9,18,27,18
2014,Oct,6,12,17,11
2014,Nov,7,13,17,10
2014,Dec,12,18,26,14
2015,Jan,12,17,24,12
2015,Feb,7,13,20,13
2015,Mar,7,12,18,11
2015,Apr,9,14,21,12
2015,May,8,13,21,13
2015,Jun,12,18,28,16
2015,Jul,13,19,26,13
2015,Aug,17,24,36,19
2015,Sep,14,21,32,18
